@@@@@@@@@@@@@@@@@@@@@@@@@@@@@@@@@@@@@@@@@@@@@@@@@@@@@@@@@@@@@@@@@@@@@@@@@@@@@@@@@@@@@@@@@@@@@@@@@@@@@@@@@@@@@@@@@@@@@@@@@@@@@@@@@@@@@@@@@@@@@@@@@@@@@
@@@@@@@@@@@@@@@@@@@@@@@@@@@@@@@@@@@@@@@@@@@@@@@@@@@@@@@@@@@@@@@@@@@@@@@@@@@@@@@@@@@@@@@@@@@@@@@@@@@@@@@@@@@@@@@@@@@@@@@@@@@@@@@@@@@@@@@@@@@@@@@@@@@@@
00000000000000000000000000000000000000000000000000000000000000000000000000000000000000000000000000000000000000000000000000000000000000000000000000000
00000000000000000000000000000000000000000000000000000000000000000000000000000000000000000000000000000000000000000000000000000000000000000000000000000
00000000000000000000000000000wwwww0000000000000000000000000000000000000000wwwww00000000000000000000000000000000000wwwww000000000000000000000000000000
0000000000000000000000000000wwwwwwww0000000000000000000000000000000000000wwwwwwww00000000000000000000000000000000wwwwwwww0000000000000000000000000000
00000000000000000000000000000wwwww0000000000000000000000000000000000000000wwwww00000000000000000000000000000000000wwwww000000000000000000000000000000
0wwwww000000000wwwww00000000000000000000000000wwwww000000000wwwww000000000000000000000wwwww000000000wwwww00000000000000000000000000000000000000000000
wwwwwwww000000wwwwwwww00000000000000000000000wwwwwwww000000wwwwwwww000000000000000000wwwwwwww000000wwwwwwww000000000000000000000000000000000000000000
0wwwww000000000wwwww00000000000000000000000000wwwww000000000wwwww000000000000000000000wwwww000000000wwwww00000000000000000000000000000000000000000000
00000000000000000000000000000000000000000000000000000000000000000000000000000000000000000000000000000000000000000000000000000000000000000000000000000
00000000000000000000000000000000000000000000000000000000000000000000000000000000000000000000000000000000000000000000000000000000000000000000000000000
00000000000000000000000000000000000000000000000000000000000000000000000000000000000000000000000000000000000000000000000000000000000000000000000000000
00000000000000000000000000000000000000000000000000000000000000000000000000000000000000000000000000000000000000000000000000000000000000000000000000000
00000000000000000000000000000000000000000000000000000000000000000000000000000000000000000000000000000000000000000000000000000000000000000000000000000
00000000000000000000000000000000000000000000000000000000000000000000000000000000000000000000000000000000000000000000000000000000000000000000000000000
00000000000000000000000000000000000000000000000000000000000000000000000000000000000000000000000000000000000000000000000000000000000000000000000000000
00000000000000000000000000000000000000000000000000000000000000000000000000000000000000000000000000000000000000000000000000000000000000000000000000000
00000000000000000000000000000000000000000000000000000000000000000000000000000000000000000000000000000000000000000000000000000000000000000000000000000
00000000000000000000000000000000000000000000000000000000000000000000000000000000000000000000000000000000000000000000000000000000000000000000000000000
00000000000000000000000000000000000000000000000000000000000000000000000000000000000000000000000000000000000000000000000000000000000000000000000000000
00000000000000000000000000000000000000000000000000000000000000000000000000000000000000000000000000000000000000000000000000000000000000000000000000000
0000000000000000^0000^000^0000000^0000^000^00000000000000000000000000000000^0000^000^0000000^0000^000^000000000^0000^000^0000000^0000^000^00000000000
00000000000000000^000^00^000000000^000^00^0000000000000000000000000000000000^000^00^000000000^000^00^00000000000^000^00^000000000^000^00^000000000000
000000000000000000^^^^^^^0000000000^^^^^^000000000000000000000000000000000000^^^^^^00000000000^^^^^^0000000000000^^^^^^00000000000^^^^^^0000000000000
000000000000000000000II000000000000000II0000000000000000000000000000000000000000II000000000000000II00000000000000000II000000000000000II00000000000000
000000000000000000000II000000000000000II0000000000000000000000000000000000000000II000000000000000II00000000000000000II000000000000000II00000000000000
000000000000000000000II000000000000000II0000000000000000000000000000000000000000II000000000000000II00000000000000000II000000000000000II00000000000000
@@@@@@@@@@@@@@@@@@@@@@@@@@@@@@@@@@@@@@@@@@@@@@@@@@@@@@@@@@@@@@@@@@@@@@@@@@@@@@@@@@@@@@@@@@@@@@@@@@@@@@@@@@@@@@@@@@@@@@@@@@@@@@@@@@@@@@@@@@@@@@@@@@@@@
@@@@@@@@@@@@@@@@@@@@@@@@@@@@@@@@@@@@@@@@@@@@@@@@@@@@@@@@@@@@@@@@@@@@@@@@@@@@@@@@@@@@@@@@@@@@@@@@@@@@@@@@@@@@@@@@@@@@@@@@@@@@@@@@@@@@@@@@@@@@@@@@@@@@@
@@@@@@@@@@@@@@@@@@@@@@@@@@@@@@@@@@@@@@@@@@@@@@@@@@@@@@@@@@@@@@@@@@@@@@@@@@@@@@@@@@@@@@@@@@@@@@@@@@@@@@@@@@@@@@@@@@@@@@@@@@@@@@@@@@@@@@@@@@@@@@@@@@@@@
@@@@@@@@@@@@@@@@@@@@@@@@@@@@@@@@@@@@@@@@@@@@@@@@@@@@@@@@@@@@@@@@@@@@@@@@@@@@@@@@@@@@@@@@@@@@@@@@@@@@@@@@@@@@@@@@@@@@@@@@@@@@@@@@@@@@@@@@@@@@@@@@@@@@@